EEEEEEWEEEEEEE
WWWWEWEEEEEEEE
EEEEWEEEEWWWEE
EEEWEEEEEEFWEE
EEWEEEEEEWWWEE
EWEEEEEEEEEEEE
SEEEEEEEEEEEEE
