EEEEEEEEE
EWWWEWWWE
EEEWEWEEE
EWWWSWWWE
EEEWWWEEE
EWWWFWWWE
EEEWEWEEE
EWWWEWWWE
EEEEEEEEE
