EWEWEWEWEEE
EWEWEWEWEWW
EEEEEEEEEEE
WWEWWWWWEWE
EWEEEWEEEWE
EWEWWWEWEWE
EEEEEWWWEWW
WWEWWWFEEEE
EEEEEWWWEWE
EWEWEWEWEWE
EWSWEEEWEEE
